|=======================|
|       |       |       |
|               |       |
|       |       |       |
|==   ====    =====   ==|
|Start                  |
|                      (|Exit!
|                       |
|==   ====    =====   ==|
|       |       |       |
|       |               |
|       |       |       |
|=======================|
